002000000
001111110
101010110
111011110
000030000
